R 1200 800
NO ./wall1.xpm
SO ./wall2.xpm
WE ./wall3.xpm
EA ./wall4.xpm
S ./red_face.xpm
F funky
C funky
GAME on
MOUSE on

11111111111111111  111111
10000000E00000021  100001
10111111111111101  101101
101           101  101101
10111111111111101  101101
10000000000000001  101101
10111111111111111  101101
1T1                1T1111