R 1200 800
NO ./brick_wall.xpm
SO ./brick_wall.xpm
WE ./brick_wall.xpm
EA ./brick_wall.xpm
#S ./red_face.xpm
S ./wolf_hitler.xpm
#F 255,159,0
#C 126,15,0
F funky
C funky
GAME on
MOUSE on

111111111111111111111111111111   1111111
100000111000000110101000000001 111000001
10100001T0000000110101000100011100000101
1000000110000000011011001010001110000011
10T0001101000110100110100110000100000111
10100110001010011111000110111010010101T1
1110000000011100101000001111000110001101
1100000000101011000100010001101001011101
1110001100110001101100100111010000110101
1111110100000011011000110110001010001111
1111T0001010000000110100000000T101001011
1111110111100000001010001100001100010001
1111101011000101010110010111011101010001
  1101111000T00010000000001111101010100T
 11011110101001100S0000001011 1111111101
1110011000111100000001001000111110001111
T010110000010000000000010000011010101T1
1101100000001000000000100000000000101011
 10001000000000000020001000000000110100T
 1111111111111111111111111111111111T1111
