F 255,159,qsdcsd
C -2,12,100
#F funky
#C funky
#GAME on
#MOUSE on

N
1111111111  T
10S001000111111
100001000000001

100000200010001
111111111110101
          10101
          11111
